Cod-ES	KEYWORD1

arreglo	LITERAL1
booleano	LITERAL1
byte	LITERAL1
caracter	LITERAL1
doble	LITERAL1
flotante	LITERAL1
entero	LITERAL1
largo	LITERAL1
corto	LITERAL1
longitud_t	LITERAL1
cadena	LITERAL1
Cadena	LITERAL1
sin_signo	LITERAL1
funcion	LITERAL1
palabra	LITERAL1

es_igual	LITERAL1
es_diferente	LITERAL1
y	LITERAL1
o	LITERAL1
no	LITERAL1

absoluto	KEYWORD2
raizCuadrada	KEYWORD2
potencia	KEYWORD2
seno	KEYWORD2
coseno	KEYWORD2
tangente	KEYWORD2
arcoSeno	KEYWORD2
arcoCoseno	KEYWORD2
arcoTangente	KEYWORD2
arcoTangente2	KEYWORD2
redondear	KEYWORD2
techo	KEYWORD2
piso	KEYWORD2
aleatoriaConSemilla	KEYWORD2
aleatorio	KEYWORD2
esPar	KEYWORD2
esImpar	KEYWORD2

inicio	KEYWORD3
bucle	KEYWORD3
fin	KEYWORD3
cerrar	KEYWORD3
si	KEYWORD3
si_no	KEYWORD3
si_no_si	KEYWORD3
entonces	KEYWORD3
repetir	KEYWORD3
repetir_con_indice	KEYWORD3
para_cada	KEYWORD3
mientras	KEYWORD3
hacer	KEYWORD3
elegir	KEYWORD3
caso	KEYWORD3
predeterminado	KEYWORD3
continuar	KEYWORD3
romper	KEYWORD3
devolver	KEYWORD3
parametros	KEYWORD3

constante	KEYWORD1
alcance	KEYWORD1
estatico	KEYWORD1
volatil	KEYWORD1

estructura	KEYWORD1
VERDADERO	LITERAL1
FALSO	LITERAL1
NULO	LITERAL1
CERO	LITERAL1

ALTO	LITERAL1
BAJO	LITERAL1
CAMBIO	LITERAL1
ESCALANDO	LITERAL1
CAYENDO	LITERAL1
ENTRADA	LITERAL1
ENTRADA_POLARIZADA	LITERAL1
SALIDA	LITERAL1
LED_INTERNO	LITERAL1
DIGITAL	LITERAL1
ANALOGICO	LITERAL1

leerBits	KEYWORD2
enviarBits	KEYWORD2
limpiarBit	KEYWORD2
leerBit	KEYWORD2
establecerBit	KEYWORD2
esAlfabetico	KEYWORD1
esAlfanumerico	KEYWORD1
esAscii	KEYWORD1
esControl	KEYWORD1
esDigito	KEYWORD1
esGrafico	KEYWORD1
esDigitoHexadecimal	KEYWORD1
esMinuscula	KEYWORD1
esImprimible	KEYWORD1
esSignoDePuntuacion	KEYWORD1
esEspacio	KEYWORD1
esMayuscula	KEYWORD1
esEspacioEnBlanco	KEYWORD1

habilitarEventos	KEYWORD2
deshabilitarEventos	KEYWORD2
habilitarEventoExterno	KEYWORD2
deshabilitarEventoExterno	KEYWORD2
pinDigitalAEvento	KEYWORD2

salidaDigital	KEYWORD2
salidaAnalogica	KEYWORD2
referenciaAnalogica	KEYWORD2
resolucionLecturaAnalogica	KEYWORD2
resolucionEscrituraAnalogica	KEYWORD2
tono	KEYWORD2
apagarTono	KEYWORD2
pulsacionEn	KEYWORD2
leerPulsoPreciso	KEYWORD2
configurarEntrada	KEYWORD2
configurarSalida	KEYWORD2
leerPin	KEYWORD2
encender	KEYWORD2
apagar	KEYWORD2

SERIE_BINARIO	LITERAL1
SERIE_OCTAL	LITERAL1
SERIE_DECIMAL	LITERAL1
SERIE_HEXADECIMAL	LITERAL1

Serie	KEYWORD1
iniciar	KEYWORD2
terminar	KEYWORD2
disponible	KEYWORD2
disponibleParaEscritura	KEYWORD2
vaciar	KEYWORD2
leerFlotante	KEYWORD2
leerEntero	KEYWORD2
espiar	KEYWORD2
imprimir	KEYWORD2
imprimirEnNuevaLinea	KEYWORD2
escribir	KEYWORD2
leer	KEYWORD2
leerBytes	KEYWORD2
leerBytesHastaEncontrar	KEYWORD2
leerCadena	KEYWORD2
leerCadenaHastaEncontrar	KEYWORD2
establecerTiempoDeEspera	KEYWORD2

MILISEGUNDOS	LITERAL1
SEGUNDOS	LITERAL1
MICROSEGUNDOS	LITERAL1

esperar	KEYWORD2

Servo	KEYWORD1
INCLUIR_SERVO	LITERAL1
adjuntar	KEYWORD2
desvincular	KEYWORD2
escribir	KEYWORD2
escribirMicrosegundos	KEYWORD2
leer	KEYWORD2
leerMicrosegundos	KEYWORD2
adjunto	KEYWORD2

TM1637	KEYWORD1
INCLUIR_TM1637	LITERAL1
ajustarBrillo	KEYWORD2
ajustarSegmentos	KEYWORD2
limpiar	KEYWORD2
mostrarDecimales	KEYWORD2
mostrarDecimalesConPuntos	KEYWORD2
mostrarHexadecimalesConPuntos	KEYWORD2
mostrarNumeroBaseConPuntos	KEYWORD2
esperarBits	KEYWORD2
iniciar	KEYWORD2
parar	KEYWORD2
escribirByte	KEYWORD2
mostrarPuntos	KEYWORD2

LedRGB	KEYWORD1
INCLUIR_LED_RGB	LITERAL1
encender	KEYWORD2
apagar	KEYWORD2
cambiarColor	KEYWORD2

MotorPAP	KEYWORD1
INCLUIR_MOTOR_PAP	LITERAL1
ajustarVelocidad	KEYWORD2
paso	KEYWORD2
version	KEYWORD2

EEPROM	KEYWORD1
INCLUIR_EEPROM	LITERAL1
leer	KEYWORD2
escribir	KEYWORD2
actualizar	KEYWORD2
iniciar	KEYWORD2
terminar	KEYWORD2
longitud	KEYWORD2
obtener	KEYWORD2
poner	KEYWORD2

LCD_I2C	KEYWORD1
INCLUIR_LCD_I2C	LITERAL1
iniciar	KEYWORD2
limpiar	KEYWORD2
regresarAlInicio	KEYWORD2
apagarDisplay	KEYWORD2
encenderDisplay	KEYWORD2
apagarParpadeo	KEYWORD2
encenderParpadeo	KEYWORD2
apagarCursor	KEYWORD2
encenderCursor	KEYWORD2
deslizarDisplayIzquierda	KEYWORD2
deslizarDisplayDerecha	KEYWORD2
imprimirIzquierda	KEYWORD2
imprimirDerecha	KEYWORD2
izquierdaADerecha	KEYWORD2
derechaAIzquierda	KEYWORD2
apagarLuz	KEYWORD2
encenderLuz	KEYWORD2
deslizarAutomaticamente	KEYWORD2
noDeslizarAutomaticamente	KEYWORD2
crearCaracter	KEYWORD2
ajustarCursor	KEYWORD2
escribir	KEYWORD2
comando	KEYWORD2
inicializar	KEYWORD2

Ultrasonico	KEYWORD1
INCLUIR_ULTRASONICO	LITERAL1
obtenerDistancia	KEYWORD2